1630,101,1
1663,93,1
1570,118,1
717,259,1
481,319,1
1446,96,1
1455,543,1
1420,99,1
249,379,1
1514,134,1
1096,149,1
127,661,1